11111111111111111111111111111111111111111111111111111111111111111111111111111111
1                                                                              1
1                       Introducing a new infected                             1
1                        f the slow mob (hp = 5)                               1
1                                                                              1
1                                                                              1
1                                                                              1
1                                                                              1
1                                                                              1
1                                 +        F                                   1
1                       H=====================                                 1
1                       H                                                      1
1                       H                                           F          >
1                       H                   H==================================1
1                       H                   H                                  1
1                       H                   H                                  1
1                       H                   H                                  1
1                       H              F    H                                  1
1                       H===================H                                  1
1                       H                  =H                                  1
1                       H                  =H                                  1	
1                       H                  =H                                  1
1                       H                  =H   %                     F        >
================================================================================	
================================================================================
